0000000000000000000000000000000000000000
0000000000000000000000000000000000000000
0000000000000000000000000000000000000000
0000000000000000000000000000000000000000
3120002111111111111111111111111120000000
0010001000000000000000000000000010000000
0021112000000000000000000000000010000000
0000000000000000000000000000000010000000
0000000000000000000000000000000010000000
0000000000000000000000000000000010000000
0000000000000000000000000000000010000000
0000002111111111111111111111111120000000
0000001000000000000000000000000000000000
0000001000000000000000000000000000000000
0000001000000000000000000000000000000000
0000001000000000000000000021111111111114
0000001000000000000000000010000000000000
0000001000000000000000000010000000000000
0000001000000000000000000010000000000000
0000001000000000000000000010000000000000
0000001000000000000000000010000000000000
0000001000000000000000000010000000000000
0000001000000000000000000010000000000000
0000001000000000000000000010000000000000
0021112000000000000000000010000000000000
0010000000000000000000000010000000000000
0010000000000000000000000010000000000000
0010000000000000000000000010000000000000
0021111111111200000000000010000000000000
0000000000000100000000000010000000000000
0000000000000100000000000010000000000000
0000000000000100000000000010000000000000
0000000000000100000000000010000000000000
0000000000000100000000000010000000000000
0000000000000100000000000010000000000000
0000000000000100000000000010000000000000
0000000000000100000000000010000000000000
0000000000000211111111111120000000000000
0000000000000000000000000000000000000000
0000000000000000000000000000000000000000

