xxxxxxxxxxxxxxxxxxxxxxxxxxxxxxxxxxxxxxxx
x00000000000000000000000000000000000000x
x-------------------------------------0x
xs11111111111111111111111111111111114-0x
x-----------------------------------2-0x
x0000000000000000000000000000000000-2-0x
x0000000000000000000000000000000000-2-0x
x0000000000000000000000000000000000-2-0x
x0----------------------------------2-0x
x0-3111111111111111111111111111111116-0x
x0-2----------------------------------0x
x0-2-0000000000000000000000000000000000x
x0-2-0000000000000000000000000000000000x
x0-2-0000000000000000000000000000000000x
x0-2-000------------------------------0x
x0-2-000-3111111111111111111111111114-0x
x0-2-000-2--------------------------2-0x
x0-2-000-2-000000000000000000000000-2-0x
x0-2-000-2-000000000000000000000000-2-0x
x0-2-000-2----------------------000-2-0x
x0-2-000-5111111111111111111114-000-2-0x
x0-2-000----------------------2-000-2-0x
x0-2-000000000000000000000000-2-000-2-0x
x0-2-000000000000000000000000-2-000-2-0x
x0-2-000000000000000000000000-2-000-2-0x
x0-2--------------------------2-000-2-0x
x0-5111111111111111111111111116-000-2-0x
x0------------------------------000-2-0x
x0000000000000000000000000000000000-2-0x
x0000000000000000000000000000000000-2-0x
x0000000000000000000000000000000000-2-0x
x0----------------------------------2-0x
x0-3111111111111111111111111111111116-0x
x0-2----------------------------------0x
x0-2-0000000000000000000000000000000000x
x0-2-----------------------------------x
x0-51111111111111111111111111111111111gx
x0-------------------------------------x
x00000000000000000000000000000000000000x
xxxxxxxxxxxxxxxxxxxxxxxxxxxxxxxxxxxxxxxx
##########
30 70
730 70
730 190
70 190
70 530
610 530
610 410
190 410
190 310
730 310
730 650
70 650
70 730
770 730
